#....##
#..#.#.####
#....###..#
##.##.#...#
#.#..@..#..#
##........#
#.#..#....#
#...##.#.##
##......###
##.....####
###########