###########
#####.#####
#####.#####
#####.#####
#....@....#
#####.#####
#####.#####
#####.#####
#####.#####
#####.#####
###########