###########
#.........#
#.........#
#.........#
#.........#
#.........#
#.........#
#.........#
#.........#
#@........#
###########